Year = 2020
Title = Insert a subtitle or author name
January = Xaneiro
February = Febreiro
March = Marzo
April = Abril
May = Maio
June = Xuño
July = Xullo
August = Agosto
September = Setembro
October = Outubro
November = Novembro
December = Decembro
Monday = Luns
Tuesday = Martes
Wednesday = Mércores
Thursday = Xoves
Friday = Venres
Saturday = Sábado
Sunday = Domingo
January caption = Insert a caption
February caption = \empty
March caption = \empty
April caption = \empty
May caption = \empty
June caption = \empty
July caption = \empty
August caption = \empty
September caption = \empty
October caption = \empty
November caption = \empty
December caption = \empty
